....................
....................
..........X.........
.......######.......
..I..............I..
####..I.I.I.I....###
.......I.I.ICI......
......--------......
....-...........-...
....................
.I.I............I.I.
####............####
.......::::::.......
.1....~~~~~~~~......
####################
