....................
...I............X...
...--..I.......--...
....I.--........I...
...--..........--...
...I......I....I....
...--....--....--...
....I...........I...
...--........I.--...
...I........--.I....
...--..........--...
....I...........I...
...--..........--...
.1..........C.......
####################
